10 10
1 4
1 | 1 | 1 | 1 | 1 11[0(0,7)3] | 1 | 1 | 1 | 1 | 1 /
1 | 0 | 0 | 1 | 0 | 0 | 0 | 0 | 0 | 1 /
1 | 1 | 0 | 0 | 0 | 0 | 0 | 0 | 0 | 1 /
1 | 1 | 1 | 0 3 | 0 | 0 | 0 | 1 | 1 | 1 /
1 | 0 | 0 | 0 | 0 | 0 | 0 | 0 | 1 | 1 /
1 | 1 | 1 | 0 | 1 | 0 | 0 | 0 7 | 0 | 1 /
1 | 1 | 1 | 1 | 0 | 0 | 0 | 0 | 0 | 1 /
1 | 0 | 1 | 0 | 0 | 0 | 0 | 0 | 1 | 1 /
1 | 0 | 0 | 0 | 0 | 1 | 1 | 0 | 1 | 1 /
1 | 1 | 1 | 1 | 1 | 1 | 1 | 1 | 1 | 1 /
