10 10
1 1
1 | 1 | 1 | 1 | 1 | 1 | 1 | 1 | 1 | 1 / 
1 | 0 | 0 | 0 | 0 | 0 | 0 | 0 | 0 | 1 / 
1 | 0 | 0 | 0 | 0 | 0 | 0 | 0 | 0 | 1 / 
1 | 0 | 0 | 0 | 0 | 0 | 0 | 0 | 0 | 1 / 
1 | 0 | 0 | 0 | 1 | 0 | 0 | 0 | 0 | 1 / 
1 | 0 | 0 | 0 | 5 | 5 | 5 | 5 | 0 | 1 11[5(1,0)2] / 
1 | 0 | 0 | 0 | 5 | 0 | 0 | 0 | 0 | 1 / 
1 11[0(14,19)0] | 0 5 | 0 5 | 0 5 | 0 5 | 1 | 0 | 0 | 0 | 1 / 
1 | 0 | 0 | 0 | 0 | 0 | 0 | 0 | 0 | 1 / 
1 | 1 | 1 | 1 | 1 | 1 | 1 | 1 | 1 | 1 / 